20 20 2 8
zHz             #   
 z      ##     z#   
       ###   ####   
##              ####
##      ### #      #
          ###       
         ##z# ##    
         ###        
###            ## ##
            o ### ##
##      ###        #
   z      ####      
    ###  ##  z##    
    ###  ###        
###            #### 
        ##      #   
    ##  ##      #   
    #  #####  ###  z
##        #     ## #
##        ##   o   #
