20 20 2 6
                    
    z     # #       
           H   ##   
   ##     # #   ##  
  ##  #             
     ###       ###  
                 #  
    z  #  #  # z  
  #    #######      
 ###     ###z   #   
       #  o  #  #   
         ###    #   
       #######  #   
  z  #  # # #       
     ##  ###  ####  
  ##  #       #  #  
  ##        # #o    
       ##   #z # #  
       #    # ## #  
       #         #  
