20 20 5 9
o              ##   
 z                  
      ####       z  
  ##     ## z       
  ##      ##    ##  
      z         #o  
                ##  
  ##     ###        
  #    #  #z #      
  ##   #     #      
          o#        
       # #   #      
   z   #     #   z  
         ###        
         #H#      # 
       #          # 
 ###  ###      #### 
 #o    #       #o   
   #  z     ####  # 
                   z
