20 20 2 8
 H              #   
        ##     z#   
       ###   ####   
##              ####
##      ### #      #
   z      ###       
       z ##  z##    
         ###        
###            ## ##
            o ### ##
##      ###        #
   z      ####      
    ###  ##  z##    
    ###  ###        
###            #### 
        ##      #   
    ##  ##      #   
    #  #####  ###  z
##        #     ## #
##   z    ##   o   #
