20 20 3 6
H      #            
   #   #  z         
            ### ### 
 #            #  #o 
       ###    #  #  
     z        #     
 ###               #
 #    ######  z    #
 #               #  
 # ##       ###  #  
 # ### ###       ## 
 #     ####      #  
 #   z   o# ###  #  
 ###      #   #  #  
       #  #         
## z   # ###  z    #
      ##   ##   ##  
  ##  ###       ##  
# ##          #     
#      o   ####     
