20 20 1 5
H           #       
         #      #   
  #   #      #      
  ## ##   # z     # 
  # # #        #    
  #   # #   #       
  #   #       #  #  
  #   # #  #        
        #  #   # z #
#    #  ####        
        #  #  #  #  
   #    #  #        
          z        #
 # z         ####   
    #  #      #  #  
          #   #  #  
  #  #        #  #  
        #  z  #  #  
 #  #        #### o 
       #  #         
