20 20 4 8
z  #    #o#    #   z
 #    #     #     # 
  #  #########   #  
#  #    ###     #  #
    z # ### #  z    
  #              #  
 ## #   ###   #  ## 
  #              #  
# ### #     # #### #
o ### #  H  # #### o
# ### #     # #### #
  #              #  
 ## #   ###   #  ## 
  #              #  
      #     #       
#   z   ###    z   #
   #    ###     #   
  #  #########   #  
 #    #     #     # 
z  #    #o#    #   z
